1 2 3 4 3 4 3 4 3 4 3 4 2 2 2 2 
2 2 3 4 3 4 3 4 3 4 3 4 2 2 2 2 
2 2 2 2 2 2 2 2 5 6 7 8 7 8 9 10 
11 12
13 14 13 14 13 14 13 14 13 14 15 16 16 16 17 12 
13 14 13 14 13 14 13 14 13 14 15 16 16 16 16 16 
16 16 16 16 16 16 18 19 20 21 22 21 23 24 25 26 
27 26
27 26 27 26 27 26 27 26 28 29 30 29 31 26 27 26 
27 26 27 26 27 26 27 26 28 29 30 29 30 29 30 29 
30 29 30 29 32 33 34 35 36 35 37 38 39 40 41 42 
43 40
44 40 44 40 44 40 45 14 13 14 46 40 41 42 43 40 
44 40 44 40 44 40 45 14 13 14 13 14 13 14 47 48 
49 48 50 20 51 52 53 54 55 56 25 26 57 58 59 26 
27 26
27 26 27 26 27 26 27 26 27 26 57 58 59 26 27 26 
27 26 27 26 27 26 27 26 27 26 27 26 57 58 60 58 
61 62 63 64 34 35 65 66 67 42 68 61 69 42 70 42 
70 42
70 42 70 42 70 42 70 42 68 61 69 42 70 42 70 42 
70 42 70 42 70 42 70 42 70 42 68 61 71 61 61 72 
73 74 72 54 75 76 77 58 78 79 60 58 60 58 60 58 
60 58
60 58 60 58 60 58 78 79 60 58 60 58 60 58 60 58 
60 58 60 58 60 58 60 58 78 79 61 61 61 62 80 66 
34 35 37 81 82 83 84 85 71 61 86 83 86 83 71 61 
86 83
71 61 86 83 84 85 71 61 86 83 86 83 71 61 86 83 
71 61 71 61 71 61 84 85 61 61 61 87 88 61 87 89 
90 91 92 93 94 95 96 97 98 93 99 93 100 97 98 93 
100 97
98 93 94 95 96 97 98 93 99 93 100 97 98 93 100 97 
97 97 101 102 103 95 104 105 106 107 108 109 110 111 112 81 
113 114 115 116 117 118 119 114 120 114 121 118 119 114 121 118 
119 114
115 116 117 118 119 114 120 114 121 118 119 114 121 118 118 118 
122 123 124 116 125 126 127 128 129 130 131 132 133 134 135 136 
136 136 136 136 136 136 136 136 136 136 136 136 136 136 136 136 
136 136
136 136 136 136 136 136 136 136 136 136 136 136 136 136 136 136 
137 138 138 138 138 138 138 138 138 138 138 139 0 0 0 0 
0 0 0 0 0 0 0 0 0 0 0 0 0 0 0 0 
0 0